border_size=1
usage=map

Xu, Xu, Xu, Xu, Xu, Xu, Xu, Xu, Xu, Xu, Xu, Xu, Xu, Xu, Xu, Xu, Xu, Xu, Xu, Xu, Xu, Xu, Xu, Xu, Uu, Xu
Xu, Xu, Xu, Xu, Xu, Xu, Xu, Xu, Uu, Uu, Uu, Xu, Xu, Xu, Xu, Xu, Xu, Xu, Uu, Xu, Uu, Xu, Ur, Uu, Uu, Uu
Xu, Xu, Xu, Xu, Xu, Xu, Xu, Xu, Uu, Ur, Ur, Xu, Xu, Xu, Uu, Uu, Uu^Ii, Xu, Uu, Qxu, Ur, Ur, Ur, Ur, Uu, Uu
Xu, Xu, Xu, Xu, Ur, Ur, Ur, Ur, Xu, Uu, Ur, Xu, Xu, Uu, Ur, Uu, Uu, Uu, Uu, Qxu^Bs/, Uu, Uu, Cud, 2 Kud, Cud, Xu
Xu, Xu, Uu, Ur, Xu, Uu, Xu, Xu, Uu, Xu, Xu, Uu, Uu, Uu, Ur, Uu, Ur, Ur, Xu, Qxu, Uu, Ur, Uu, Cud, Xu, Xu
Xu, Xu, Uu, Xu, Uh, Uh, Uh, Uu, Uu, Uu^Vud, Uu^Uf, Uu, Xu, Ur, Ur, Uu, Ur, Ur, Xu, Qxu, Ur, Ur, Xu, Uu, Xu, Xu
Xu, Xu, Uu, Xu, Uh, Uh, Uu, Xu, Xu, Uu, Uu, Uu^Uf, Ur, Xu, Xu, Uu, Ur, Xu, Xu, Uu, Uu, Xu, Uu, Uu, Uu, Xu
Xu, Xu, Xu, Uu, Uh, Uu, Xu, Ur, Ur, Uu, Xu, Ur, Xu, Uu, Uu, Xu, Ur, Xu, Xu, Uu, Uu, Uu, Uu, Ur, Ur, Xu
Xu, Xu, Uu^Uf, Uu^Uf, Uu^Vud, Ur, Ur, Xu, Xu, Ur, Uu, Xu, Xu, Uu^Uf, Uu, Ur, Xu, Xu, Xu, Xu, Uu, Uh, Uh, Ur, Uh, Xu
Xu, Xu, Uh, Uu^Uf, Uu^Ii, Uu, Xu, Xu, Uh, Xu, Uu, Xu, Ur, Xu, Uu, Ur, Ur, Xu, Uu^Uf, Uu, Uu, Uh, Uh, Xu, Uh, Xu
Xu, Uh, Uu, Uh, Xu, Xu, Xu, Xu, Uh, Ur, Xu, Ur, Xu, Uu, Xu, Xu, Xu, Ur, Uu, Xu, Ur, Uu^Uf, Uh, Uh, Ql, Xu
Xu, Xu, Uu, Xu, Xu, Xu, Xu, Uh, Uh, Uh^Ii, Ur, Ur, Xu, Xu, Uu, Ur, Uu, Xu, Xu, Uu, Ur, Uu^Vu, Uh, Ql, Xu, Xu
Xu, Uu, Ur, Xu, Xu, Xu, Xu, Uh, Uh, Xu, Uu, Ur, Uu, Xu, Ur, Xu, Ur, Xu, Xu, Ur, Ur, Ql, Ql, Uh, Xu, Xu
Xu, Uu, Ur, Xu, Uu, Xu, Ur, Xu, Xu, Xu, Xu, Ur, Ur, Uu, Ur, Xu, Cud, Kud, Xu, Xu, Ur, Ur, Ql^Bs/, Uh, Ql, Xu
Xu, Xu, Uu, Ur, Xu, Uu, Xu, Ur, Ur, Ur, Ur, Xu, Ur, Xu, Xu, Ur, Uu, Xu, Xu, Uu^Uf, Uu, Uu, Ql, Ql^Bs|, Ql, Xu
Xu, Uu, Xu, Ur, Ur, Xu, Ur, Ur, Xu, Uu, Ur, Ur, Uu, Xu, Xu, Xu, Uu, Xu, Uu^Ii, Ur, Xu, Uu, Xu, Uu, Uu, Xu
Xu, Uu, Xu, Xu, Xu, Xu, Uu, Xu, Xu, Uu, Uu, Xu, Uu, Uu^Vud, Ur, Uu^Ii, Ur, Ur, Xu, Uu^Ii, Ur, Ur, Xu, Uu, Uu, Xu
Xu, Ur, Ur, Xu, Xu, Uu, Ur, Xu, Xu, Xu, Uu, Xu, Ur, Uu, Xu, Uu, Xu, Ur, Uu^Vud, Xu, Xu, Ur, Xu, Xu, Uu, Uu
Xu, Xu, Xu, Uu, Xu, Xu, Ur, Ur, Xu, Xu, Uu, Ur, Xu, Xu, Ur, Uu, Xu, Uu, Ur, Xu, Ur, Ur, Uu^Ii, Uu, Xu, Xu
Xu, Xu, Xu, Ur, Ur, Xu, Ur, Ur, Uu^Vu, Xu, Xu, Xu, Qxu, Xu, Ur, Xu, Uu, Ur, Xu, Xu, Ur, Ur, Xu, Xu, Xu, Xu
Xu, Xu, Xu, Xu, Uu^Vud, Uu, Uu^Uf, Uu^Uf, Uu^Uf, Uu, Ur, Uu, Ur, Qxu^Bs/, Qxu, Xu, Xu, Ur, Xu, Xu, Xu, Ur, Uu, Xu, Xu, Xu
Xu, Xu, Uu, Uu^Ii, Uh, Uh, Uu^Uf, Uu^Uf, Uu, Ur, Xu, Xu, Xu, Ur, Uu, Xu, Xu, Ur, Uu, Xu, Ur, Xu, Uu, Xu, Xu, Xu
Uu, Uu, Uh, Uh, Ce, Ce, Ce, Uu, Uu, Ur, Uu, Xu, Xu, Uu, Ur, Ur, Ur, Xu, Ur, Ur, Uh, Ur, Ur, Xu, Xu, Xu
Ur, Uh, Uh, Uh, Ce, 1 Ke, Ce, Uh, Uh, Uu^Vud, Uh, Xu, Ur, Uu, Xu, Uh, Uh, Ur, Uh, Uh, Uu, Ur, Ur, Xu, Xu, Xu
Ur, Ur, Ur, Uu, Uu, Ce, Uu, Uh, Uh, Uu, Uh, Uu, Uu, Xu, Xu, Xu, Xu, Uh, Xu, Xu, Xu, Ur, Ur, Xu, Xu, Xu
Ur, Ur, Ur, Ur, Uu, Uu, Uu, Uh, Uu, Uu, Uu, Uu, Xu, Xu, Xu, Xu, Xu, Xu, Xu, Xu, Xu, Uu, Ur, Uu, Xu, Xu
