border_size=1
usage=map

Gg, Gg, Gg, Gg, Gs^Fp, Gs^Fp, Gs^Fp, Gs^Fp, Gg, Gg, Gg, Gg, Gg, Hh, Hh, Gg, Gg, Gg, Ww, Ww, Ds, Ds, Ds, Gg, Gg, Gg, Gg, Gg, Gs^Fp, Gs^Fp, Gs^Fp, Gs^Fp, Gs^Fp, Gs^Fp, Gg, Gg, Gg, Gg, Wo, Gs^Fp, Re, Ww, Ww, Ww, Ww, Ww, Ww, Gg, Gg, Gg, Gg, Gs^Fp, Gg, Gg
Ww, Gg, Gg, Gg, Gs^Fp, Gs^Fp, Gs^Fp, Gs^Fp, Gs^Fp, Gg, Gg, Gg, Gg, Gg, Gg, Gg, Gs^Fp, Gs^Fp, Ww, Ww, Ds, Ds, Ds, Aa, Gg, Gg, Gg, Gg, Gg, Gs^Fp, Gs^Fp, Gg, Gg, Gg, Gs^Fp, Gg, Gg, Gg, Wo, Gg, Re, Gs^Fp, Ww, Ww, Ww, Ww, Ww, Gg, Gg, Gg, Gs^Fp, Gg, Gg, Gg
Hh, Gs^Fp, Gg, Gg, Gs^Fp, Gs^Fp, Gs^Fp, Gg, Gg, Gs^Fp, Gg, Gg, Gg, Gg, Gg, Gg, Gs^Fp, Gs^Fp, Gg, Ww, Ww, Gg, Aa, Aa, Aa, Gg, Gg, Gs^Fp, Gg, Gs^Fp, Gg, Gg, Gg, Ss, Gs^Fp, Gg, Gg, Gg, Gg, Gg, Re, Ww, Ww, Ww, Ww, Ww, Gs^Fp, Gg, Gg, Gs^Fp, Gs^Fp, Gg, Hh, Hh
Gs^Fp, Gs^Fp, Gs^Fp, Gs^Fp, Gs^Fp, Gs^Fp, Gg, Gg, Gg, Gg, Gg, Ch, Ch, Ch, Gs^Fp, Gs^Fp, Gs^Fp, Gs^Fp, Gs^Fp, Ww, Ww, Ww, Aa, Aa, Aa, Re, Re, Re, Re, Ch, Ch, Ch, Gg, Ss, Gs^Fp, Gg, Gg, Gg, Gs^Fp, Gg, Re, Gg, Gg, Gg, Gg, Ww, Gg, Gs^Fp, Gs^Fp, Gs^Fp, Gg, Hh, Mm, Mm
Ww, Ww, Gs^Fp, Ds, Gs^Fp, Gg, Gs^Fp, Gs^Fp, Gs^Fp, Gg, Gg, Ch, 2 Kh, Ch, Gs^Fp, Re, Gs^Fp, Gs^Fp, Gs^Fp, Gs^Fp, Ww, Ww, Aa, Aa, Aa, Gg, Gg, Gg, Gg, Ch, 4 Kh, Ch, Gs^Fp, Gs^Fp, Gs^Fp, Gg, Gg, Gg, Re, Re, Gg, Gg, Gg, Gg, Gg, Ww, Gg, Gg, Gg, Gg, Gg, Hh, Mm, Mm
Gs^Fp, Ww, Ds, Ds, Ds, Gg, Gs^Fp, Gs^Fp, Gs^Fp, Gs^Fp, Ch, Ch, Ch, Gg, Gg, Gs^Fp, Gs^Fp, Gs^Fp, Gs^Fp, Ww, Ww, Ww, Gg, Aa, Aa, Aa, Aa, Aa, Ch, Ch, Ch, Re, Re, Gs^Fp, Gs^Fp, Gg, Re, Re, Gg, Gg, Gg, Wo, Ww, Ww, Gg, Ww, Gg, Gg, Gg, Gg, Gg, Gg, Wo, Mm
Gg, Ww, Ww, Wo, Ds, Gs^Fp, Gs^Fp, Gs^Fp, Gs^Fp, Gs^Fp, Gs^Fp, Gs^Fp, Gs^Fp, Gs^Fp, Gg, Gg, Gg, Gs^Fp, Gs^Fp, Gs^Fp, Ww, Ww, Ww, Gg, Gg, Aa, Aa, Aa, Aa, Gg, Gg, Gg, Gg, Re, Re, Re, Re, Gg, Gg, Gg, Gg, Wo, Ww, Ww, Ww, Ww, Aa, Aa, Gg, Gg, Gg, Gs^Fp, Wo, Wo
Gs^Fp, Ds, Ds, Ds, Gs^Fp, Gg, Gg, Gs^Fp, Gs^Fp, Gs^Fp, Gg, Gs^Fp, Gs^Fp, Gg, Gg, Gg, Gs^Fp, Gs^Fp, Gs^Fp, Gs^Fp, Gs^Fp, Hh, Hh^Fp, Gg, Gg, Gg, Gg, Gg, Gg, Gg, Gs^Fp, Gg, Gg, Hh, Hh, Hh, Re, Gg, Gg, Gg, Aa, Aa, Gg, Ww, Gg, Aa, Aa, Aa, Gg, Gg, Gg, Wo, Wo, Wo
Ds, Ds, Ds, Gg, Gs^Fp, Gg, Gg, Gg, Gs^Fp, Gs^Fp, Gs^Fp, Gs^Fp, Gg, Gs^Fp, Gg, Gs^Fp, Aa, Gs^Fp, Gs^Fp, Gs^Fp, Gs^Fp, Hh^Fp, Hh^Fp, Hh^Fp, Hh^Fp, Gg, Gg, Gg, Gg, Gs^Fp, Gs^Fp, Gg, Gg, Hh, Hh, Hh, Re, Gg, Gg, Aa, Aa, Aa, Gg, Gg, Gg, Aa, Aa, Aa, Gg, Gg, Wo, Wo, Wo, Wo
Gg, Gg, Gs^Fp, Gg, Gg, Gg, Gg, Gg, Gs^Fp, Gs^Fp, Hh, Hh, Hh, Hh, Gg, Gg, Gg, Aa, Aa, Gs^Fp, Hh, Hh^Fp, Hh^Fp, Hh^Fp, Hh^Fp, Gs^Fp, Gs^Fp, Gg, Gg, Gs^Fp, Gs^Fp, Hh, Hh, Hh, Hh, Hh, Re, Gg, Gg, Aa, Aa, Aa, Aa, Aa, Aa, Aa, Aa, Gg, Wo, Wo, Wo, Wo, Gs^Fp, Gg
Gs^Fp, Gs^Fp, Gs^Fp, Gg, Ww, Ww, Ww, Gg, Gs^Fp, Gs^Fp, Hh, Hh, Hh, Gg, Gg, Gg, Gg, Aa, Aa, Gg, Hh, Hh^Fp, Gg, Hh^Fp, Gs^Fp, Gs^Fp, Gs^Fp, Gg, Gg, Gg, Hh, Hh, Hh, Hh, Gg, Gg, Gg, Re, Re, Aa, Aa, Aa, Aa, Ha, Ha, Ha, Ha, Hh, Wo, Wo, Wo, Wo, Gg, Gg
Gs^Fp, Gs^Fp, Gs^Fp, Gg, Ww, Ww, Ww, Gg, Hh, Hh, Mm, Mm, Mm, Mm, Gg, Gg, Gg, Gg, Aa, Aa, Gg, Gg, Gg, Gg, Gs^Fp, Gs^Fp, Gs^Fp, Gg, Gg, Gg, Gg, Hh, Gg, Gg, Gg, Gg, Aa, Aa, Re, Aa, Aa, Aa, Ha, Mm, Mm, Mm, Mm, Hh, Wo, Wo, Wo, Gg, Hh, Gg
Gs^Fp, Gs^Fp, Ww, Ww, Ww, Ww, Ww, Ww, Hh, Hh, Hh, Mm, Mm, Mm, Mm, Mm, Hh, Gg, Gg, Gg, Gg, Gg, Gg, Gg, Gg, Gg, Gg, Gg, Ce, Ce, Ce, Gg, Gg, Gg, Gg, Gg, Aa, Aa, Aa, Re, Aa^Fpa, Ha, Mm, Ai, Mm, Ww, Mm, Wo, Wo, Wo, Wo, Gg, Hh, Ha
Gg, Gs^Fp, Gg, Ww, Ww, Ww, Ww, Gg, Gg, Hh, Mm, Mm, Mm, Mm, Mm, Mm, Hh, Gg, Aa, Aa, Aa, Gg, Gg, Gg, Gg, Hh, Hh, Gg, 3 Ke, Ce, Gg, Ce, Gg, Gg, Gg, Gg, Aa, Aa, Ha, Re, Aa, Ha, Mm, Ww, Ai, Ww, Wo, Wo, Wo, Wo, Gg, Gg, Hh, Mm
Gg, Gg, Gg, Ww, Gs^Fp, Ww, Gs^Fp, Gs^Fp, Gs^Fp, Hh, Mm, Mm, Mm, Mm, Mm, Hh, Gg, Gg, Aa, Aa, Ww, Ww, Ww, Gg, Hh, Hh, Hh, Gg, Ce, Ce, Aa, Aa, Aa, Aa, Aa, Ds, Aa, Aa^Fpa, Aa, Re, Hh, Mm, Mm, Ww, Ww, Ww, Wo, Wo, Wo, Gg, Wo, Wo, Wo, Ha
Gg, Gg, Gg, Gg, Gs^Fp, Gs^Fp, Gs^Fp, Gs^Fp, Gg, Hh, Mm, Ww, Ww, Mm, Mm, Hh, Gg, Gg, Aa, Aa, Ww, Ww, Ww, Ww, Ww, Hh, Gg, Gs^Fp, Gg, Gg, Gg, Gg, Aa, Aa, Ds, Ds, Wo, Ha, Aa, Re, Re, Hh, Hh, Ww, Ww, Ww, Ww, Wo, Wo, Gg, Wo, Gg^Fet, Wo, Hh
Gg, Gg, Gg, Gg, Gs^Fp, Gs^Fp, Gs^Fp, Gs^Fp, Gs^Fp, Ha, Ww, Ww, Ww, Ww, Ww, Ww, Gg, Aa, Aa, Ha, Ww, Ww, Ww, Ww, Hh, Ww, Gg, Gg, Gs^Fp, Gg, Ds, Ds, Ds, Ds, Ds, Wo, Wo, Aa, Aa, Gg, Re, Gg, Hh, Ai, Ww, Gg, Ch, Wo, Wo, Gg, Gg, Wwrg, Gg, Gg
Gg, Gg, Gs^Fp, Gg, Gg, Gs^Fp, Gg, Gs^Fp, Gs^Fp, Hh, Ww, Ww, Ww, Ww, Ww, Ww, Gg, Gg, Gg, Ww, Ww, Ww, Hh, Gg, Gg, Ww, Ww, Gg, Gg, Ds, Wo, Wo, Wo, Wo, Wo, Wo, Wo, Ai, Wo, Wo, Gg, Re, Re, Re, Re, Re, Wo, Wo, Re, Gg, Gg, Gg, Gg, Gg
Gg, Gg, Gs^Fp, Gs^Fp, Gg, Gg, Gg, Gs^Fp, Gs^Fp, Gs^Fp, Ww, Ww, Ww, Ww, Ww, Gg, Gs^Fp, Gs^Fp, Ww, Ww, Ww, Ww, Ww, Gg, Gg, Ww, Ww, Ww, Gg, Wo, Wo, Wo, Ds, Ds, Ds, Ds, Aa, Ai, Wo, Wo, Wo, Wo, Wo, Wo, Wo, Wo, Gg, Gg, Re, Aa, Aa, Aa, Gg, Gg
Gg, Gs^Fp, Gs^Fp, Gg, Gs^Fp, Gs^Fp, Gs^Fp, Gg, Hh, Mm, Mm, Ww, Ww, Ww, Ww, Gs^Fp, Gs^Fp, Gs^Fp, Ww, Ww, Ww, Ww, Ww, Ww, Gg, Gg, Ww, Ww, Gg, Wo, Ww, Ds, Ww, Ds, Ww, Gg, Aa, Aa, Aa, Gg, Wo, Wo, Wo, Gg, Gs^Fp, Wo, Gg, Gg, Aa, Aa, Aa, Aa, Aa, Aa
Gg, Gg, Gs^Fp, Gs^Fp, Gs^Fp, Gs^Fp, Gs^Fp, Gg, Hh, Mm, Mm, Mm, Ww, Ww, Ww, Ww, Ww, Ww, Ww, Ww, Ww, Gg, Ww, Gg, Ww, Ww, Ww, Ss, Gg, Wo, Ww, Ww, Ww, Ww, Ww, Ww, Aa, Aa, Aa, Aa, Wo, Wo, Gg, Gg, Gg, Gg, Gg, Gg, Re, Gg, Gg, Aa, Aa, Aa
Gs^Fp, Gs^Fp, Gs^Fp, Gs^Fp, Gs^Fp, Gs^Fp, Gg, Gg, Hh, Mm, Mm, Mm, Ww, Ww, Ww, Ww, Ww, Ww, Ww, Ww, Ww, Ww, Ww, Aa, Ww, Gg, Gg, Gg, Ss, Ww, Ww, Ww, Ww, Ww, Ww, Ww, Aa, Aa, Aa, Aa, Wo, Wo, Gg, Gg, Gs^Fp, Gg, Gg, Gg, Re, Gg, Gg, Gg, Aa, Aa
Gg, Gs^Fp, Gg, Gg, Gg, Gg, Gg, Gg, Gs^Fp, Hh, Mm, Mm, Mm, Ww, Ww, Ww, Ww, Ww, Gg, Gg, Gg, Gg, Ww, Ww, Gg, Gg, Ss, Ss, Ww, Ww, Ww, Ww, Ww, Ww, Aa, Ww, Ww, Aa, Wo, Aa, Wo, Wo, Ww, Gs^Fp, Gs^Fp, Gg, Gg, Gg, Re, Gg, Gg, Gg, Gg, Gg
Gg, Gg, Gg, Gg, Gg, Gg, Gg, Gg, Gs^Fp, Hh, Hh, Hh, Mm, Ww, Ww, Ww, Ww, Hh, Gg, Hh, Hh, Hh, Gg, Gg, Gg, Gg, Ww, Ww, Ww, Ww, Ww, Ww, Ww, Aa, Aa, Ww, Wo, Wo, Wo, Wo, Wo, Wo, Ww, Gs^Fp, Gg, Gg, Gg, Gg, Re, Gg, Gg, Gg, Gg, Gg
Gg, Gg, Gg, Gg, Gg, Gg, Gg, Gg, Gg, Gg, Gg, Hh, Hh, Mm, Mm, Ww, Hh, Gg, Hh, Gg, Ww, Mm, Hh, Gg, Gg, Ww, Ww, Ww, Ww, Ww, Ww, Ww, Ww, Ww, Ww, Ww, Wo, Wo, Wo, Wo, Ww, Ww, Gs^Fp, Gs^Fp, Gg, Gg, Gg, Ch, Ch, Ch, Gs^Fp, Gs^Fp, Gg, Gg
Gg, Gg, Gg^Vh, Gg, Gg, Gg, Gg, Gg, Gg, Gg, Gg, Gg, Gg, Gg, Gg, Gg, Gg, Gg, Ww, Ww, Ww, Ww, Ww, Ww, Ww, Ww, Ww, Ww, Ww, Ww, Ww, Ww, Aa, Aa, Ww, Ww, Ww, Wo, Wo, Wo, Ww, Hh, Gg, Gg, Gg, Gg, Gg, Ch, 1 Kh, Ch, Hh, Gs^Fp, Hh, Hh
Gg, Gg, Gg, Gg, Gg, Gg, Gg, Gg, Gg, Gg, Gg, Gg, Gg, Gg, Gg, Gg, Gg, Ww, Ww, Ww, Ww, Ww, Ww, Hh, Ww, Ww, Ww, Ww, Ww, Ww, Ww, Ww, Ww, Aa, Ww, Ww, Ww, Ww, Ww, Ww, Ww, Gg, Gg, Gg, Gg, Gg, Ch, Ch, Ch, Gg, Hh, Hh, Gg, Hh
Gg, Gg, Gg, Gg, Gg, Gg, Gg, Gg, Gg, Gg, Gg, Gg, Gg, Gg, Gg, Gg, Gg, Ww, Ww, Ai, Ww, Ww, Ww, Ww, Ww, Ww, Ww, Ww, Ww, Ww, Ww, Ww, Ww, Ww, Aa, Ww, Ww, Ww, Ww, Ww, Ww, Gg, Gg, Gg, Re, Gg, Re, Re, Gg, Gg, Hh, Gg, Hh, Hh
Gg, Gg, Gg, Gg, Gg, Gg, Gg, Gg, Gg, Gg, Gg, Gg, Gg, Gg, Gg, Gg, Gg, Gg, Ha, Ww, Ww, Ww, Ww, Ww, Ww, Ww, Ww, Ww, Ww, Ww, Aa, Ww, Ww, Aa, Aa, Aa, Aa, Ww, Ww, Ww, Re, Re, Re, Re, Gs^Fp, Re, Gg, Gg, Gg, Gg, Gg, Gg, Hh, Mm
Gg, Gg, Gg, Gg, Gg, Gg, Gg, Gg, Gg, Gg, Gg, Hh, Gg, Gg, Gg, Gg, Gg, Gg, Aa, Ww, Ww, Gg, Ww, Ww, Ww, Ww, Ww, Ww, Ww, Ww, Ww, Ww, Ww, Ww, Ww, Aa, Ww, Ww, Ww, Gs^Fp, Re, Gs^Fp, Gg, Gg, Gg, Gg, Gg, Gg, Aa, Gg, Gg, Gg, Ww, Mm
Aa, Gg, Gg, Gg, Gg, Gg, Aa, Gg, Gg, Hh, Hh, Ha, Aa, Gg, Ww, Ww, Ww, Gg, Ww, Ww, Ww, Ww, Ww, Ww, Ww, Ww, Ww, Ww, Ww, Ww, Ww, Ww, Ww, Ww, Ww, Ww, Ww, Ww, Ww, Ww, Re, Gs^Fp, Gg, Gg, Gg, Hh, Hh, Gg, Aa, Gg, Ww, Aa, Ww, Ww
Gg, Gg, Gg, Aa, Aa, Aa, Aa, Aa, Ha, Ha, Mm, Mm, Hh, Ww, Ww, Ww, Ww, Ww, Ww, Ww, Ww, Ww, Ww, Ww, Ww, Ww, Ww, Ww, Ww, Ww, Ww, Ww, Ww, Ww, Ww, Ww, Ww, Ww, Ww, Ww, Ds, Ds, Gs^Fp, Gg, Gg, Hh, Hh, Hh, Gg, Ww, Ww, Ww, Ww, Ww
Gg, Gg, Gg, Aa, Aa, Aa, Aa, Aa, Ha, Mm, Mm, Mm, Hh, Ww, Ww, Ww, Ww, Ww, Ww, Ww, Ww, Ww, Ww, Ww, Ww, Ww, Ww, Ww, Ww, Ww, Ww, Ww, Ww, Ww, Ww, Ww, Ww, Ww, Ww, Ww, Ds, Ds, Gs^Fp, Gg, Aa, Aa, Hh, Ww, Ww, Ww, Ww, Ww, Ww, Ww
