border_size=1
usage=map

Xue, Xue, Xue, Xue, Xue, Xue, Xue, Xue, Xue, Xue, Xue, Xue, Xue, Xue, Xue, Xue, Xue, Xue, Xue, Xue, Xue, Xue, Xue, Xue, Xue, Xue, Xue, Xue, Xue, Xue, Xue, Xue, Xue, Xue, Xue, Xue, Xue, Xue, Xue, Xue, Xue, Xue
Xue, Xue, Xue, Xue, Xue, Xue, Xue, Xue, Xue, Xue, Xue, Xue, Xue, Xue, Xue, Xue, Xue, Xue, Xue, Xue, Xue, Xue, Xue, Xue, Xue, Xue, Xue, Xue, Xue, Xue, Xue, Xue, Xue, Xue, Xue, Xue, Xue, Xue, Xue, Xue, Xue, Xue
Xue, Xue, Xue, Xue, Xue, Xue, Xue, Xue, Ur, Ur, Ur, Ur, Ur, Ur, Ur, Ur, Ur, Ur, Ur, Ur, Ur, Ur, Ur, Ur, Ur, Ur, Ur, Ur, Ur, Ur, Ur, Ur, Ur, Ur, Ur, Xue, Xue, Xue, Xue, Xue, Xue, Xue
Xue, Xue, Xue, Xue, Xue, Xue, Xue, Ur, Xue, Xue, Xue, Xue, Xue, Xue, Xue, Xue, Xue, Xue, Xue, Xue, Xue, Xue, Xue, Xue, Xue, Xue, Xue, Xue, Xue, Xue, Xue, Xue, Xue, Xue, Xue, Ur, Ur, Xue, Xue, Xue, Xue, Xue
Xue, Xue, Xue, Xue, Xue, Xue, Gg, Gg, Gg, Gg, Gg, Gg, Gg, Gg, Gg, Gg, Gg, Gg, Gg, Gg, Gg, Gg, Gg, Gg, Gg, Gg, Gg, Gg, Gg, Gg, Gg, Gg, Gg, Gg, Gg, Xue, Xue, Ur, Xue, Xue, Xue, Xue
Xue, Xue, Xue, Xue, Xue, Xue, Gll^Fp, Gg, Gll^Fp, Gll^Fp, Gg, Gg, Gg, Gll^Fp, Gll^Fp, Gg, Gg, Gg, Gg, Gll^Fp, Gll^Fp, Gll^Fp, Gll^Fp, Gg, Gll^Fp, Gll^Fp, Gll^Fp, Gll^Fp, Gll^Fp, Gll^Fp, Gll^Fp, Gg, Gll^Fp, Gll^Fp, Gll^Fp, Xue, Ur, Ur, Xue, Xue, Xue, Xue
Xue, Xue, Xue, Xue, Xue, Xue, Gll^Fp, Gll^Fp, Gll^Fp, Gg, Gg, Gg, Gg, Gg, Gll^Fp, Gg, Gg, Gg, Gg, Gg, Gg, Gg, Gg, Gll^Fp, Gg, Gg, Gg, Gg, Gg, Gll^Fp, Gll^Fp, Gll^Fp, Gll^Fp, Gg, Gll^Fp, Xue, Ur, Xue, Xue, Xue, Xue, Xue
Xue, Xue, Xue, Xue, Xue, Xue, Gll^Fp, Gll^Fp, Gll^Fp, Gg, Gg, Gll^Fp, Gg, Gg, Gll^Fp, Gll^Fp, Gll^Fp, Gg, Gg, Gg, Gll^Fp, Gll^Fp, Gg, Gg, Gg, Hh, Gg, Gg, Gg, Gg, Gg, Gg, Gg, Gg, Gll^Fp, Xue, Xue, Ur, Xue, Xue, Xue, Xue
Xue, Xue, Xue, Xue, Xue, Xue, Gll^Fp, Gll^Fp, Gll^Fp, Gg, Gg, Gg, Hh, Gg, Gg, Gg, Gll^Fp, Gll^Fp, Gg, Gg, Gg, Gg, Hh, Gg, Gll^Fp, Gll^Fp, Gll^Fp, Gg, Gg, Gg, Cv, Gg, Gg, Gll^Fp, Gll^Fp, Xue, Ur, Ur, Xue, Xue, Xue, Xue
Xue, Xue, Ur, Xue, Xue, Xue, Gg, Gg, Gll^Fp, Gg, Gg, Hh, Hh^Vhh, Hh, Gll^Fp, Gll^Fp, Gll^Fp, Gll^Fp, Gll^Fp, Gll^Fp, Gg, Gg, Gg, Gll^Fp, Gg, Gll^Fp, Gg, Gg, Gg, Cv, 2 Kv, Cv, Gg, Gll^Fp, Gll^Fp, Xue, Ur, Xue, Xue, Xue, Xue, Xue
Xue, Uu, Xue, Uu, Gg, Xue, Gll^Fp, Gg, Gg, Gg, Gg, Gg, Gg, Gg, Gll^Fp, Gll^Fp, Gg, Gll^Fp, Gll^Fp, Gg, Gg, Gg^Ve, Gg, Gg, Gg, Gg, Gg^Gvs, Gg^Gvs, Gg^Gvs, Cv, Cv, Cv, Gg, Gg, Gg, Xue, Xue, Ur, Ur, Xue, Xue, Xue
Xue, Ur, Ur, Xue, Xue, Gg, Gg, Gg, Gg, Gg, Gg^Gvs, Gg^Gvs, Gg^Gvs, Gg, Gg, Gll^Fp, Gg, Gll^Fp, Gll^Fp, Gll^Fp, Gll^Fp, Gg, Gg, Gg, Gg, Gg^Ve, Gg^Gvs, Gg^Gvs, Gg^Gvs, Gg, Gg, Gg, Gg, Gg, Gg, Xue, Xue, Xue, Xue, Ur, Xue, Xue
Xue, Ur, Uu^Vud, Xue, Xue, Xue, Ww, Gg, 1 Ke, Ce, Gg^Gvs, Gg^Gvs, Gg^Gvs, Gg, Gg, Gg, Gg, Gll^Fp, Gg, Gll^Fp, Gg, Gg, Gg, Gg, Gg, Gg, Gll^Fp, Gg^Gvs, Gg, Gg^Wm, Gll^Fp, Gg, Gg, Gg, Gg, Xue, Xue, Xue, Xue, Ur, Xue, Xue
Xue, Xue, Xue, Ur, Ur, Xue, Gg, Ww, Ww, Ce, Gg, Gg^Gvs, Gg, Gg, Ww, Gll^Fp, Gll^Fp, Gg, Gll^Fp, Gg, Gg, Gg, Gll^Fp, Gll^Fp, Gg, Gg, Gg, Gll^Fp, Gg, Gll^Fp, Gll^Fp, Gg, Gg^Ve, Gg, Gg, Xue, Xue, Xue, Xue, Ur, Xue, Xue
Xue, Xue, Kud, Uu, Ur, Xue, Ww, Gg, Mm, Ww, Ww^Bw|, Gg, Ww, Gg, Ww, Ww, Ww, Gll^Fp, Gg, Gg, Gg, Gg, Gll^Fp, Gg, Mm, Gg, Gg, Gg, Gg, Gll^Fp, Gg, Gg, Gg, Gg, Gg, Xue, Xue, Xue, Xue, Ur, Xue, Xue
Xue, Xue, Cud, Xue, Ur, Xue, Ww, Ww, Ww, Gg, Ww^Bw|, Ww, Wo, Ww, Wo, Wo, Ww, Ww, Ww, Ww, Gg, Gg, Gll^Fp, Gg, Gg, Gg, Gg, Gll^Fp, Gll^Fp, Gll^Fp, Gg, Gg, Gg, Gg, Gg, Xue, Xue, Xue, Xue, Ur, Xue, Xue
Xue, Xue, Cud, Xue, Ur, Ww, Wo, Wo, Ss, Ww, Ww^Bw|, Wo, Wo, Wo, Wo, Ww, Ww, Ww, Ww, Gg, Gg, Gg, Gg, Gg, Gll^Fp, Gll^Fp, Gll^Fp, Gll^Fp, Gll^Fp, Gg, Gg, Gg, Gg, Hh, Hh, Xue, Xue, Xue, Ur, Ur, Xue, Xue
Xue, Xue, Ur, Cud, Ur, Xue, Gll^Fp, Gg, Gg, Ww, Ww^Bw|, Ww, Ww, Wo, Ww, Ww, Gll, Gg, Gg, Ww^Bw/, Ww, Hh, Gg, Gg, Gg, Gg, Gll^Fp, Gg, Gg, Gg, Ww, Ww, Ww, Hh, Hh, Xue, Ur, Ur, Xue, Xue, Xue, Xue
Xue, Xue, Uh, Xue, Ur, Xue, Gll^Fp, Gg, Gg, Cv, Gll^Fp, Ww, Gg, Ww, Gll, Gll, Mv, Gll, Gll, Gg, Ss, Ww, Ww, Gll^Fp, Gll^Fp, Ww, Ww, Ww, Ww, Ww, Wo, Ww, Ww, Gg, Gg, Xue, Ur, Xue, Xue, Xue, Xue, Xue
Xue, Xue, Xue, Ur, Ur, Xue, Gg, Gll^Fp, Gg, Gg, Gll^Fp, Gg, Gll^Fp, Gg, Gll, Mm, Mm, Mm, Gll, Gg, Gg, Ss, Gg, Ww, Ww, Ww, Wo, Wo, Wo, Wo, Ww, Ww, Ww, Gg, Gg, Xue, Xue, Ur, Ur, Ur, Ur, Xue
Xue, Xue, Xue, Xue, Ur, Xue, Gll^Fp, Gll^Fp, Gll^Fp, Gg, Gg, Gll^Fp, Gll^Fp, Gll^Fp, Gll^Fp, Gll, Gll, Gll, Gg, Gg, Gg^Ve, Gg, Cv, Ww, Wo, Wo, Wo, Wo, Wo, Wo, Wo, Ww, Hh, Hh, Gg, Xue, Xue, Xue, Xue, Xue, Ur, Xue
Xue, Xue, Ur, Uu^Vud, Xue, Xue, Gll^Fp, Gll^Fp, Gll^Fp, Gg, Gg, Gll^Fp, Gg, Gg, Gll^Fp, Gll^Fp, Gll^Fp, Gll^Fp, Gg, Gg, Gg, Gg, Gg, Ww, Ww, Wo, Ww, Wo, Ww, Wo, Wo, Ww, Ww, Hh, Gg, Xue, Xue, Xue, Ur, Ur, Xue, Xue
Xue, Xue, Uu, Xue, Xue, Xue, Gll^Fp, Gll^Fp, Hh, Gg, Gll^Fp, Gll^Fp, Gg, Gll^Fp, Gg, Gg, Gg, Gg, Gg, Gll^Fp, Gg, Ww, Ww, Ww, Gg, Ww, Gll^Fp, Ww, Ww, Ww, Ww, Ww, Ww, Gg, Gg, Xue, Ur, Ur, Xue, Xue, Xue, Xue
Xue, Xue, Uu, Ur, Ur, Xue, Gll^Fp, Gll^Fp, Gg, Gg, Gll^Fp, Gll^Fp, Gg, Gg, Gg, Gg, Gg^Ve, Gll^Fp, Gll^Fp, Gg, Gg, Ww, Ww, Gll^Fp, Gg, Gll^Fp, Gll^Fp, Gll^Fp, Gg, Gll^Fp, Ww, Ww, Ww, Gg^Gvs, Gg^Gvs, Xue, Ur, Xue, Xue, Xue, Xue, Xue
Xue, Xue, Uu, Xue, Ur, Xue, Gg, Gg, Gg, Gg, Gg, Gg, Gg, Mm, Hh, Hh, Gg, Gll^Fp, Gg, Gll^Fp, Gll^Fp, Hh, Ww, Gg, Gll^Fp, Gg, Cv, Gll^Fp, Gg, Gg, Gll^Fp, Ww, Gg^Gvs, Gg^Gvs, Gg^Gvs, Xue, Xue, Ur, Ur, Ur, Ur, Xue
Xue, Xue, Xue, Ur, Xue, Xue, Gg, Gll^Fp, Gll^Fp, Hh, Gg^Ve, Gg, Gg, Ce, Gg, Gg, Gg, Gll^Fp, Gg, Gg, Gll^Fp, Gll^Fp, Ww, Gg, Gll^Fp, Gg, Gll^Fp, Cv, Gll^Fp, Gll^Fp, Gg, Hh, Hh, Gg^Gvs, Gg, Xue, Xue, Xue, Xue, Xue, Ur, Xue
Xue, Xue, Xue, Ur, Uu^Vud, Xue, Ww, Gg, Gll^Fp, Gg, Gg, Ce, Co, Co, Co, Ce, Mm, Gg, Gg, Gg, Gll^Fp, Gll^Fp, Ww, Ww, Ww, Gll^Fp, Cv, Kv, Gg, Gg, Hh, Hh, Gg, Gg, Gg, Xue, Xue, Xue, Ur, Ur, Xue, Xue
Xue, Xue, Xue, Xue, Xue, Gg, Gg, Ww, Ww, Gg, Gg, Gg, Co, 3 Ko, Co, Gg, Gg, Gg, Gll^Fp, Gll^Fp, Gll^Fp, Gg, Gg, Gg, Gg, Ww, Ww^Bw/, Gg, Gg^Ve, Gg, Hh, Gg, Gg, Gg, Xue, Xue, Ur, Ur, Xue, Xue, Xue, Xue
Xue, Xue, Xue, Xue, Xue, Xue, Gg, Gg, Gg, Ww^Bw/, Ww, Ce, Gg, Co, Gg, Ce, Ww, Gg^Ve, Ww, Gll^Fp, Gll^Fp, Gll^Fp, Gll^Fp, Gg, Gg, Gg, Ww, Gg, Gg, Gg, Hh, Gg, Gg, Xue, Ur, Ur, Xue, Xue, Xue, Xue, Xue, Xue
Xue, Xue, Uu, Xue, Xue, Xue, Gg, Gg, Gg^Gvs, Gg^Gvs, Gg^Gvs, Ww, Ww, Ce, Ww, Ww, Ww, Ww, Ww, Ww, Ww, Gll^Fp, Gll^Fp, Gg, Ww, Ww, Gg, Gg, Xue, Gg, Gg, Gg, Xue, Xue, Ur, Xue, Xue, Xue, Xue, Xue, Xue, Xue
Xue, Uu, Xue, Uh, Xue, Xue, Gll^Fp, Gg, Gg^Gvs, Gg^Gvs, Gg^Gvs, Gg^Ve, Gg, Ww, Ww, Ww, Wo, Wo, Wo, Ww, Ww, Gg, Ww, Ww, Gg, Gg, Xue, Xue, Xue, Xue, Xue, Xue, Xue, Xue, Xue, Ur, Xue, Xue, Xue, Xue, Xue, Xue
Xue, Uu^Vu, Xue, Uh, Xue, Xue, Gll^Fp, Gg, Gg, Gg^Gvs, Gll^Fp, Gg, Gg, Ww, Ww^Vm, Ww, Ww, Wo, Ww, Wo, Ww, Ww, Ww, Gg, Gg, Gg, Xue, Xue, Xue, Xue, Xue, Xue, Xue, Xue, Ur, Ur, Xue, Xue, Xue, Xue, Xue, Xue
Xue, Uh, Ur, Ur, Xue, Xue, Gg, Gll^Fp, Gll^Fp, Gg, Gll^Fp, Gll^Fp, Gg, Ww, Gg, Ww, Ww, Ww, Ww, Ww, Ww, Ww, Ww, Gg, Gg, Xue, Xue, Xue, Xue, Xue, Xue, Xue, Gg, Xue, Ur, Xue, Xue, Xue, Xue, Xue, Xue, Xue
Xue, Xue, Ur, Xue, Uu, Ur, Gg, Gll^Fp, Gll^Fp, Gg, Gll^Fp, Gg, Mm, Gg, Gg, Ww, Gg, Gg^Gvs, Gg^Gvs, Ww, Gg, Ww, Xue, Xue, Xue, Xue, Xue, Xue, Xue, Xue, Gg, Gg, Gg, Gg, Xue, Xue, Xue, Xue, Xue, Xue, Xue, Xue
Xue, Xue, Ur, Uh, Xue, Xue, Xue, Gll^Fp, Gll^Fp, Gg, Xue, Gg, Gg, Gg, Gg, Gg, Hh, Gg, Gg, Gg, Xue, Xue, Xue, Xue, Xue, Xue, Xue, Xue, Gg, Gg, Gg, Gg, Xue, Xue, Xue, Xue, Xue, Xue, Xue, Xue, Xue, Xue
Xue, Xue, Ur, Xue, Ur, Ur, Xue, Xue, Xue, Xue, Xue, Xue, Xue, Gg, Xue, Xue, Mm, Hh, Gg, Gll^Fp, Xue, Xue, Xue, Xue, Xue, Xue, Xue, Xue, Gg, Gg, Gg^Ve, Gg, Gg, Xue, Gll^Fp, Xue, Xue, Xue, Xue, Xue, Xue, Xue
Ur, Ur, Xue, Uu^Vu, Ur, Xue, Xue, Gg, Gg, Gg^Ve, Gg, Xue, Xue, Xue, Xue, Wo, Xue, Hh, Xue, Xue, Xue, Xue, Xue, Xue, Xue, Xue, Gg, Gll^Fp, Gg, Gg, Hh, Hh, Gg, Gll^Fp, Gll^Fp, Xue, Xue, Xue, Xue, Xue, Xue, Xue
Xue, Xue, Xue, Xue, Xue, Xue, Xue, Xue, Xue, Gg, Gg, Gg, Gg, Xue, Xue, Xue, Xue, Xue, Gg, Xue, Xue, Xue, Xue, Xue, Gg, Gll^Fp, Gg, Gg, Gg, Hh, Mm, Hh, Gg, Gll^Fp, Gll^Fp, Gll^Fp, Xue, Xue, Xue, Xue, Xue, Xue
Xue, Xue, Xue, Xue, Xue, Xue, Xue, Gll^Fp, Gg^Ve, Gg, Gg, Gg, Gg, Gg, Gg, Xue, Gg, Gg, Mm, Gg, Gg, Gg, Gg, Gg, Hh, Gg, Gg, Gg, Gg, Gg, Gg, Gg, Gg^Ve, Gll^Fp, Gll^Fp, Gll^Fp, Xue, Xue, Xue, Xue, Xue, Xue
Xue, Xue, Xue, Xue, Xue, Xue, Xue, Gll^Fp, Mm, Gg, Gg, Gg^Ve, Gg, Gg, Gg, Gg, Gg, Mm, Gg, Gg^Ve, Gg, Gll^Fp, Gg, Gg, Gg, Gg^Ve, Gg, Gg, Mm, Hh, Gll^Fp, Gg, Gll^Fp, Gll^Fp, Gll^Fp, Gll^Fp, Xue, Xue, Xue, Xue, Xue, Xue
Xue, Xue, Xue, Xue, Xue, Xue, Xue, Gg, Gg, Gg, Gg, Gg, Gll^Fp, Gg, Gll^Fp, Gll^Fp, Gg, Gg, Gg, Gll^Fp, Gll^Fp, Gg, Gg, Gg, Gg, Gg, Gg, Gg, Gg, Gll^Fp, Gg, Gll^Fp, Gg, Gll^Fp, Gll^Fp, Gll^Fp, Xue, Xue, Xue, Xue, Xue, Xue
